xinfeng => 信封
daziji => 打字机
weidianzi => 微电子
weishengfuwuzhongxin => 卫生服务中心
jiaotong => 交通
yidongduanceshi => 移动端测试
dongshizhangzhuli => 董事长助理
dianji => 电机
guanlizixun => 管理咨询
wujin => 五金
dianrebei => 电热杯
tuiguang => APP推广
fuyinji => 复印机
xitongjicheng1 => 系统集成
dianxinwangluogongchengshi => 电信网络工程师
dianqishejigongchengshi => 电气设计工程师
chuzhongjiaoshi => 初中教师
xingyezhuanyongjixiejishebei => 行业专用机械及设备
jiangzaoyinshebei => 降噪音设备
touzi => 投资VP
xian => 线
guangxuejizhaoxiangqicai => 光学及照相器材
luntai => 轮胎
yingeryongpin => 婴儿用品
jianzhu => 建筑
muyinghuli => 母婴护理
jianyankeyishi => 检验科医师
jichang => 机场
jinshugongyipin => 金属工艺品
meijietoufang => 媒介投放
fensi => 粉丝
chatou => 插头
sheying => 摄影
fangdechanguihuakaifa => 房地产规划开发
wawa => 娃娃
jinshubaozhuangyongpin => 金属包装用品
renliziyuan1 => 人力资源
yonghuyanjiuyuan => 用户研究员
weiboyunying => 微博运营
riyujiaoshi => 日语教师
ruanzhuangshejishi => 软装设计师
paiqishan => 排气扇
lvyoucehuashi => 旅游策划师
taobaodian => 淘宝店
xingzhengjingli => 行政经理
fangyingyuan => 放映员
jianzhushejishi => 建筑设计师
tumutujianjiegougongchengshi => 土木/土建/结构工程师
shiyou => 石油
xiehonggongcheng => 泻洪工程
feiji => 飞机
baojingzhuangzhi => 报警装置
huanbaolvhua => 环保绿化
cansi => 蚕丝
shoutao => 手套
waiyi => 外衣
youyisheshi => 游艺设施
zihua => 字画
wuzijiuzaiwuzi => 物资救灾物资
maoyigendan => 贸易跟单
zujian => 组件
yizhiwanju => 益智玩具
taocigongyipin => 陶瓷工艺品
menzhenbu => 门诊部
shuju => 数据
waitao => 外套
zhinengxitong => 智能系统
qingjie => 清洁
zhengfuguanxi => 政府关系
shufajiaoshi => 书法教师
yirenzhuli => 艺人助理
qichedianzi => 汽车电子
qicheyinxiang => 汽车音响
flash_development => Flash开发
wangzhanyunying => 网站运营
datangjingli => 大堂经理
chufangsheshi => 厨房设施
kekejizhipin => 可可及制品
peixunjigou => 培训机构
shujufuwu => 数据服务
ranqi => 燃气
shuiku => 水库
tiyuqicai => 体育器材
bashi => 巴士
zi => 籽
jinshusiwang => 金属丝网
dianchaoguo => 电炒锅
lvyouguwen => 旅游顾问
ganyishebei => 干衣设备
cheliangyunying => 车辆运营
yuangongguanxi => 员工关系
yiliaoqixiexiaoshou => 医疗器械销售
detieyongshebeiqicai => 地铁用设备器材
jiaohuanji => 交换机
zhongyi => 中医
chenyi => 衬衣
wushuichulisheshi => 污水处理设施
zhuangshi => 装饰
yidongtongxingongchengshi => 移动通信工程师
tuanduijingli => 团队经理
jinglizhuli => 经理助理
baoguanbaojianyuan => 报关/报检员
doulei => 豆类
changyi => 肠衣
zixingche => 自行车
lvshishiwusuo => 律师事务所
meijieguwen => 媒介顾问
diannao => 电脑
zidonghua => 自动化
tushuziliao => 图书资料
chubeiwuzi => 储备物资
dianqi1 => 电气
yingjianchanpinjingli => 硬件产品经理
ka => IP卡
tiyuchangguanjianshegongcheng => 体育场馆建设工程
yule => 娱乐
kuajingdianshang => 跨境电商
jingyongshebei => 警用设备
zhuangshihe => 装饰盒
yingjiangongchengshi => 硬件工程师
youxijiemianshejishi => 游戏界面设计师
wenancehua => 文案策划
caiwu => 财务
gongyinglianzongjian => 供应链总监
jiayongkongdiao => 家用空调
jieneng => 节能
dakehudaibiao => 大客户代表
fengkong => 风控
zaojiaolaoshi => 早教老师
cuihuajijihuaxuezhuji => 催化剂及化学助剂
chongdianqi => 充电器
yonghuyanjiujingli => 用户研究经理
mugong => 木工
yujin => 浴巾
zaojiao => 早教
yangrongshan => 羊绒衫
diaokegongyipin => 雕刻工艺品
wangluoanquan => 网络安全
shiyanshiyongpin => 实验室用品
tongye => 铜业
xianshishebei => 显示设备
qicheweixiu => 汽车维修
zhuzaoduanzaogongchengshi => 铸造/锻造工程师
guangdianzi => 光电子
fangdechancehua => 房地产策划
dechanzhaotoubiao => 地产招投标
maichangjingli => 卖场经理
chongwujiyongpin => 宠物及用品
jiangjieyuan => 讲解员
jixieshejizhizao => 机械设计/制造
youxijiaose => 游戏角色
android_peixunjiangshi => Android培训讲师
biaopai => 标牌
jingujian => 紧固件
yuanzhangfuyuanzhang => 园长/副园长
tianranqi => 天然气
tianxian => 天线
zhuangxiu => 装修
zidonghua1 => 自动化
peixuncehua => 培训策划
zhizhibaozhuangyongpin => 纸制包装用品
keshimenling => 可视门铃
zhuanyezixun => 专业咨询
tuoguanzhongxin => 托管中心
jiuhuche => 救护车
maozi => 帽子
lifu => 礼服
yanjiuyuan => 研究院
kongdiao => 空调
huoyun => 货运
yiliaoqixieshengchanzhiliangguanli => 医疗器械生产/质量管理
jiudianqiantai => 酒店前台
jiushengyuan => 救生员
boyinzhuchijiaoshi => 播音主持教师
jidiao => 计调
yangfashi => 养发师
tianranlinbaohu => 天然林保护
dayinji => 打印机
yiliaoxiaoshou => 医疗销售
caigouzhuguan => 采购主管
shizhenggongcheng => 市政工程
banzhizaoshebei => 板制造设备
mugongjixie => 木工机械
eyufanyi => 俄语翻译
shiyongjun => 食用菌
paiban => 排版
zhenzhi => 针织
fuzhuangchang => 服装厂
canyin1 => 餐饮
wangluokefu => 网络客服
shenheyuan => 审核员
dianchigongchengshi => 电池工程师
zhuduanjian => 铸锻件
caiwuzhuguan => 财务主管
qichemeirong => 汽车美容
bubence => 簿本册
peixunxuexiao => 培训学校
shujucangku => 数据仓库
zhubao => 珠宝
nongyongjixie => 农用机械
pige => 皮革
chongwu => 宠物
wuliuzongjian => 物流总监
mucaijiagong => 木材加工
bolishengchanjiagongjixie => 玻璃生产加工机械
geizaoyeji => 给皂液机
yuanhuashi => 原画师
mianzhiwu => 棉织物
yunweizongjian => 运维总监
xiaofangzhongkongyuan => 消防中控员
c2_development => C#开发
zhijiang => 纸浆
zixundiaoyan => 咨询/调研
zhoucheng => 轴承
yishubumenzhuanyongcailiaojiyongpin => 艺术部门专用材料及用品
liangshi => 粮食
gongnengceshi => 功能测试
celveyunying => 策略运营
shuiwu => 税务
hushizhang => 护士长
sizhiwu => 丝织物
binguanjiudianyongpin => 宾馆酒店用品
yaopinshengchan => 药品生产
zixunjingli => 咨询经理
meitishi => 美体师
yuanlinlvhuagongcheng => 园林绿化工程
shipinjiagong => 食品加工
guangdian1 => 光电
qianduan => web前端
peixunyanjiu => 培训研究
xiwangong => 洗碗工
duiduobanyunjixie => 堆垛搬运机械
fpga_kaifa => FPGA开发
suanfagongchengshi => 算法工程师
diandianzhangweixiuzhanzhang => 4S店店长/维修站长
dianshan => 电扇
wangyeshejishi => 网页设计师
feixingqijipeijian => 飞行器及配件
qingjieyongpin => 清洁用品
qicheyongpin => 汽车用品
fanglei => 防雷
wuliujingli => 物流经理
hunlianzixunshi => 婚恋咨询师
dba => DBA
renliziyuanzhuanyuan => 人力资源专员
shengchanjihuaguanli => 生产计划管理
peixun1 => 培训
shiyoujizhipin => 石油及制品
chuju => 厨具
chuanmei => 传媒
shengchanyuan => 生产员
jianghe => 江河
shidudiaojieqi => 湿度调节器
ganshouji => 干手机
yixueyingxiangfangshekeyishi => 医学影像/放射科医师
mogong => 磨工
jiaohushejishi => 交互设计师
meikuang => 煤矿
gongzuofu => 工作服
shangyeshujufenxi => 商业数据分析
xingzhengzhuanyuan => 行政专员
xiaoshouguanli => 销售管理
tupianchuli => 图片处理
fushixiemaoshejijiagong => 服饰鞋帽设计加工
suizhiji => 碎纸机
yanguangshi => 验光师
youqigong => 油漆工
caizhuang => 彩妆
shijueshejizongjian => 视觉设计总监
huodongyunying => 活动运营
java_peixunjiangshi => JAVA培训讲师
sezhi => 色织
zhubaoshoushi => 珠宝首饰
dongwutiquwu => 动物提取物
yaodian => 药店
pigejizhipinshejijiagong => 皮革及制品设计加工
qichexiaoshou1 => 汽车销售
jiajusheji => 家具设计
qichepeijianxiaoshou => 汽车配件销售
tuzaijirouleichujiagongshebei => 屠宰及肉类初加工设备
fangshui => 防水
xiangliao => 香料
kongzhihediaozhengshebei => 控制和调整设备
shujuwajue => 数据挖掘
jiaoshi => 教师
meirongshi => 美容师
jiaodai => 胶带
shijuesheji => 视觉设计
lvshizhuli => 律师助理
huagongfeiliaojichulisheshi => 化工废料及处理设施
dianzichang => 电子厂
jiadianzhizaoshebei => 家电制造设备
bangongmuzhipin => 办公木制品
shujuyunying => 数据运营
quyuzongjian => 区域总监
meitijiaolian => 美体教练
mojugongchengshi => 模具工程师
fengrengong => 缝纫工
tielugongcheng => 铁路工程
runhuayou => 润滑油
wuliu => 物流
pcb_gongyi => PCB工艺
dianhuaxiaoshou => 电话销售
jinshuxianguan => 金属线管
minjiangongyipin => 民间工艺品
chufangdianqi => 厨房电器
shichangyingxiao => 市场营销
huoyundailijingli => 货运代理经理
mianlei => 棉类
gaojiguanlizhiwei => 高级管理职位
cixingcailiao => 磁性材料
yaofang => 药房
rouzhipin => 肉制品
yuyinshibie => 语音识别
zhubozhuli => 主播助理
faxingshi => 发型师
houduankaifa => 后端开发
jishuhehuoren => 技术合伙人
guanggaoxiaoshou => 广告销售
gongchengzaojia => 工程造价
chushizhang => 厨师长
qichezhizao => 汽车制造
ranliao1 => 燃料
xueche => 学车
ruanjianceshi => 软件测试
yunyingjingli => 运营经理
zhiyeguwen => 置业顾问
zhengxingshi => 整形师
lvyoufuwu => 旅游服务
yaokongqi => 遥控器
motuochexiaoshou => 摩托车销售
hanyuchaoxianyufanyi => 韩语/朝鲜语翻译
binggou => 并购
ganguo => 干果
xitongguanliyuan => 系统管理员
guanggaochuangyisheji => 广告创意设计
hehuoren => 合伙人
huaxuejiaoshi => 化学教师
xiangjiaojizhipin => 橡胶及制品
jianzhushigong => 建筑施工
erlang_development => Erlang开发
fangdechanxiaoshouzongjian => 房地产销售总监
diandugong => 电镀工
pensugong => 喷塑工
jisuanji => 计算机
hanjiegongchengshi => 焊接工程师
shujubiaozhu => 数据标注
pugongcaozuogong => 普工/操作工
qiangticailiao => 墙体材料
gaoduanjishuzhiwei => 高端技术职位
youxituiguang => 游戏推广
xiaohaopin => 消耗品
jiayongjinshuzhipin => 家用金属制品
cmo => CMO
caihuipeixunjiangshi => 财会培训讲师
qiyeguanlizixun => 企业管理咨询
tielu => 铁路
nongye => 农业
wulijiaoshi => 物理教师
lvxingmianbaoche => 旅行面包车
xiangjiao => 橡胶
huafei => 化肥
xiangmuzhuanyuan => 项目专员
xiaoshouzongjian => 销售总监
xiaofangqicai => 消防器材
jiqirenjiaoshi => 机器人教师
jinshujiancai => 金属建材
qudongkaifa => 驱动开发
shoushi => 首饰
daogou => 导购
bolibaozhuangyongpin => 玻璃包装用品
xingzhengzongjian => 行政总监
huizhan => 会展
chubanfaxing => 出版发行
zichanguanli => 资产管理
miandianshi => 面点师
hugong => 护工
dengju => 灯具
diandongche => 电动车
renliziyuanzixunguwen => 人力资源咨询顾问
hupozhiligongcheng => 湖泊治理工程
feiqichulisheshi => 废气处理设施
shuzhigongyipin => 树脂工艺品
fuzongjingli => 副总经理
daoyanbiandao => 导演/编导
ziliaoyuan => 资料员
jianzhujidiangongchengshi => 建筑机电工程师
jiaxiao => 驾校
yingjianxiangmujingli => 硬件项目经理
hunlicehua => 婚礼策划
shuiyi => 睡衣
fanghanfu => 防寒服
gongyeyongbu => 工业用布
penjing => 盆景
diaoyu => 钓鱼
huiyihuodongcehua => 会议活动策划
dailishangxiaoshou => 代理商销售
guzhangfenxishi => 故障分析师
zuzhuanggong => 组装工
jiaotonggongju => 交通工具
chuanbojipeijian => 船舶及配件
xiangmuzhuguan => 项目主管
zongbian => 总编
jiaoyiyuan => 交易员
shuichanjizhipin => 水产及制品
xieye => 鞋业
waiyupeixun => 外语培训
yunyingzhuli => 运营助理
cangkuguanliyuan => 仓库管理员
jianzhusheji => 建筑设计
cailiaogongchengshi => 材料工程师
shicaishiliao => 石材石料
baoshiyushigongyipin => 宝石玉石工艺品
chubanshe => 出版社
jiajusheji2 => 家居设计
guzhengjiaoshi => 古筝教师
wanjuqiang => 玩具枪
huazhuangpin => 化妆品
yunweigongchengshi => 运维工程师
tuxiangshibie => 图像识别
chengshijingli => 城市经理
yixuezongjian => 医学总监
guolu => 锅炉
cailiaobangongjiaju => 材料办公家具
tongxinbiaozhunhuagongchengshi => 通信标准化工程师
dengguangshi => 灯光师
wenjiao => 文教
yousejinshu => 有色金属
hedaoshujungongcheng => 河道疏浚工程
maopifuzhuang => 毛皮服装
shujuchanpinjingli => 数据产品经理
kefuzhuguan => 客服主管
shuilishuidiansheshi => 水利水电设施
zhensuo => 诊所
chanpinyunying => 产品运营
rongzi => 融资
tengwei => 藤苇
tangcijizhipin => 搪瓷及制品
dianzidiangongchanpinshejijiagong => 电子电工产品设计加工
pigeyuanliao => 皮革原料
xitonggongchengshi => 系统工程师
zhongcanchushi => 中餐厨师
shiliaogongyipin => 石料工艺品
shishangshipin => 时尚饰品
geipaishuigongchengshi => 给排水工程师
jixiezhitu => 机械制图
gaobingmianbao => 糕饼面包
jiaobanji => 搅拌机
reshuiqi => 热水器
golang_development => Golang开发
qianrushi => 嵌入式
qiantai => 前台
zhuanlilvshi => 专利律师
gancao => 干草
ershoudiannaojiyongpin => 二手电脑及用品
fuzhuangsheji => 服装设计
dongzhiwuyou => 动植物油
suliaogongyipin => 塑料工艺品
liyiyingbinjiedai => 礼仪/迎宾/接待
maogong => 铆工
qiegegong => 切割工
huagongfeiliao => 化工废料
caibianxiezuochuban => 采编/写作/出版
yousejinshuhejinzhipin => 有色金属合金制品
hushi => 护士
banyungong => 搬运工
leqi => 乐器
shudianshebeijicailiao => 输电设备及材料
jianli => 监理
youxitexiao => 游戏特效
caiwuzongjian => 财务总监
xiaoshou_vp => 销售VP
yinshuachubanfu => 印刷出版服
bandaoticailiao => 半导体材料
huakuang => 画框
yuwenjiaoshi => 语文教师
diannaowaishe => 电脑外设
shiyongyou => 食用油
bileichanpin => 避雷产品
yingyuanzhuoyi => 影院桌椅
yinshua => 印刷
zongcai => 总裁
shipinbianji => 视频编辑
zixunzongjian => 咨询总监
yayunyuan => 押运员
mutan => 木炭
meitan => 煤炭
jiaxiaojiaolian => 驾校教练
yibiao => 仪表
choushagongyifangzhi => 抽纱工艺纺织
zhiwubianzhigongyipin => 植物编织工艺品
mote => 模特
xinliyisheng => 心理医生
siliao => 饲料
jianzhujixiangguanshebei => 建筑及相关设备
jiaowuguanli => 教务管理
jianzhuboli => 建筑玻璃
xiuxianfuzhuang => 休闲服装
fangdaosheshi => 防盗设施
dongshihuimishu => 董事会秘书
maopi => 毛皮
puke => 扑克
shipintianjiaji => 食品添加剂
zhengyunxidishebei => 整熨洗涤设备
guanggaoxiediao => 广告协调
yinliao => 饮料
jianshi => 监视
jieriyongpin => 节日用品
jiaju1 => 家居
tongxinjishugongchengshi => 通信技术工程师
fawuzongjian => 法务总监
dudaoxundian => 督导/巡店
yaoshikoulian => 钥匙扣链
kafeiji => 咖啡机
wangzhanyouhua => 网站优化
shichangcehua => 市场策划
yeya => 液压
renliziyuanzongjian => 人力资源总监
shenji => 审计
lvxingshe => 旅行社
waimao => 外贸
baojie => 保洁
gonggonghuanweisheshi => 公共环卫设施
dianzi => 电子
javascript => JavaScript
ershouchepinggushi => 二手车评估师
diaoweipin => 调味品
lvye => 铝业
touhouguanli => 投后管理
jianguo => 坚果
yundongyongpin => 运动用品
liliaoshi => 理疗师
dechanzhaotoubiaozongjian => 地产招投标总监
diantigong => 电梯工
jiayouzhanshebei => 加油站设备
xiaoshouzhuli => 销售助理
gongyesheji => 工业设计
mucai => 木材
jixiejiegougongchengshi => 机械结构工程师
jizhonggongnuan => 集中供暖
mofen => 墨粉
suoju1 => 索具
dezhi => 地质
yingtongyongpin => 婴童用品
cjj_development => C++开发
hexinwanggongchengshi => 核心网工程师
wangzhanbianji => 网站编辑
zixinpinggu => 资信评估
wangluoshebei => 网络设备
muzhigongyipin => 木制工艺品
meijiezongjian => 媒介总监
hrbp => HRBP
sheyingshexiang => 摄影/摄像
mianliao => 面料
jianshenqicai => 健身器材
wanjuzhu => 玩具珠
ershouyinshuashebei => 二手印刷设备
xiaoxue => 小学
jiazheng => 家政
zhaoming => 照明
huwaiyongpin => 户外用品
php_development => PHP开发
chanpinzhuli => 产品助理
renxiangxiutushi => 人像修图师
xiaoshouyunying => 销售运营
gaozhongjiaoshi => 高中教师
jiudianjingli => 酒店经理
qudaoxiaoshou => 渠道销售
diaoduyuan => 调度员
tiyuyongpin => 体育用品
zuoyebaohu => 作业保护
guanggaolipin => 广告礼品
shipinjixie => 食品机械
liangyou => 粮油
likejiaoshi => 理科教师
gaoduanfangdechanzhiwei => 高端房地产职位
zhiliangguanliceshi => 质量管理/测试
zhiyepeixun => 职业培训
guojimaoyi => 国际贸易
meifaxuetu => 美发学徒
daxue => 大学
shujutongxingongchengshi => 数据通信工程师
huiyihuodongzhixing => 会议活动执行
yugalaoshi => 瑜伽老师
yuyi => 浴衣
mohe => 墨盒
yuanlinlvhuayongpinjijixie => 园林绿化用品及机械
mijijia => 密集架
wuyezhaoshangguanli => 物业招商管理
yuyingshi => 育婴师
banjingong => 钣金工
jipuche => 吉普车
tingchechang => 停车场
feiliaohuishouzailiyong => 废料回收再利用
lvyou => 旅游
guanggaowenan => 广告文案
taoci => 陶瓷
fangshenggongyipin => 仿生工艺品
fuzhuang => 服装
meijiehezuo => 媒介合作
caigouzongjian => 采购总监
dianfanbao => 电饭煲
chuna => 出纳
neiwaishishejigongchengshi => 内外饰设计工程师
hunsha => 婚纱
biaoyanjiaoshi => 表演教师
xibanyayufanyi => 西班牙语翻译
dianziyuanqijian => 电子元器件
yejin => 冶金
jiaoche => 轿车
jingche => 警车
biansuji => 变速机
qichemeirong1 => 汽车美容
shichangdiaoyan => 市场调研
riyufanyi => 日语翻译
shigongcailiao => 施工材料
yelianjiagong => 冶炼加工
xiangshui => 香水
pigefeiliao => 皮革废料
yiliaoqixie => 医疗器械
bangongshebei => 办公设备
penhui => 喷绘
tongxin => 通信
tongxinxiangmujingli => 通信项目经理
pinleiyunying => 品类运营
shequyunying => 社区运营
lanqiuyumaoqiujiaolian => 篮球/羽毛球教练
chongyagongchengshi => 冲压工程师
nongyongzhuanyongwuzi => 农用专用物资
guangchuanshugongchengshi => 光传输工程师
yidongdianhua => 移动电话
baozhuangjixie => 包装机械
shenghuofuwu => 生活服务
guanggaozhizuo => 广告制作
peisongyuan => 配送员
shipinyinliaoyanfa => 食品/饮料研发
ios_development => iOS开发
yuanlinjingguansheji => 园林/景观设计
meijiezhuanyuan => 媒介专员
zongzhu => 总助
xiaoshoujingli => 销售经理
baowenrongqi => 保温容器
lajiche => 垃圾车
jinyinqi => 金银器
zongjingli => 总经理
yingyujiaoshi => 英语教师
youmo => 油墨
c_development => C开发
jiajuzhizaojixie => 家具制造机械
weisheng => 卫生
jishuzongjian => 技术总监
jiesuan => 结算
baozhuanggong => 包装工
guanggaosheji => 广告设计
u3d => U3D
paifengshebei => 排风设备
wangluo => 网络
xicanchushi => 西餐厨师
baozhuangcailiao => 包装材料
jisuanjipeixun => 计算机IT培训
zhengquan => 证券
yidongqianduan => 移动web前端
jianzhugongcheng => 建筑工程
baozhuangshejijiagong => 包装设计加工
qindan => 禽蛋
xitonggongcheng => 系统工程
qichexitong => 汽车系统
qichegaizhuanggongchengshi => 汽车改装工程师
kache => 卡车
fadianji => 发电机
xiangyan => 香烟
shouyin => 收银
shiyanshijishuyuan => 实验室技术员
shiyouzhuanyongjixieshebei => 石油专用机械设备
shengxunxitong => 声讯系统
maoyi => 毛衣
huazhuangshi => 化妆师
qitazaikeqiche => 其它载客汽车
qimochanpinzhizaoshebei => 汽摩产品制造设备
kongqijinghuaqi => 空气净化器
yingyupeixun => 英语培训
jiaoxuemoxing => 教学模型
dianzigongchengshi => 电子工程师
shejishizhuli => 设计师助理
shineisheji1 => 室内设计
fawujingli => 法务经理
cuxiaoyuan => 促销员
xitujixituzhipin => 稀土及稀土制品
youjihuagongyuanliao => 有机化工原料
shejijingli => 设计经理
dianshangyunying => 电商运营
gongyinglianjingli => 供应链经理
huijishishiwusuo => 会计师事务所
binguan => 宾馆
zhuanyongqiche => 专用汽车
zhuzao => 铸造
guangxue => 光学
yonghuyanjiuzongjian => 用户研究总监
jiankangguwen => 健康顾问
guiyuan => 柜员
wenkejiaoshi => 文科教师
detieanjian => 地铁安检
weijin => 围巾
zhifu => 制服
shipin => 食品
shitingqicai => 视听器材
bingchuangdengyiyuanyongjiaju => 病床等医院用家具
deshi => 的士
chanchesiji => 铲车司机
lingshi => 零食
yingjianceshi => 硬件测试
dongmanpeixunjiangshi => 动漫培训讲师
huolifadianshebei => 火力发电设备
qingjieyongju => 清洁用具
jinshuzhipin => 金属制品
voice2video2figure_development => 语音/视频/图形开发
sheji => CAD设计
xiangjing => 香精
binyihuohuashebei => 殡仪火化设备
tuoersuo => 托儿所
wanjushejijiagong => 玩具设计加工
dianchuifeng => 电吹风
juchang => 剧场
app_shejishi => APP设计师
it_peixun => IT培训
qianzhengzhuanyuan => 签证专员
jueyuancailiao => 绝缘材料
feijinshuchulisheshi => 废金属处理设施
jiayongdianshiji => 家用电视机
dianyuan => 电源
etl_gongchengshi => ETL工程师
cuishouyuan => 催收员
chouyouyanji => 抽油烟机
jichengdianlusheji => 集成电路IC设计
caibian => 采编
ruodiangongchengshi => 弱电工程师
gerenbaoyang => 个人保养
shixunhuiyixitong => 视讯会议系统
jishuzhichi => IT技术支持
legaojiaoshi => 乐高教师
meirongdianzhang => 美容店长
qiangong => 钳工
guolugong => 锅炉工
guoren => 果仁
huizhanxiangmujingli => 会展项目经理
quyufuzeren => 区域负责人
yanyuanpeiyinmote => 演员/配音/模特
hulianwangjinrong => 互联网金融
zixunxiangmuguanli => 咨询项目管理
zhiwutiquwu => 植物提取物
yaojishi => 药剂师
kangfuzhiliaoshi => 康复治疗师
heisejinshujizhipin => 黑色金属及制品
qiaoliang => 桥梁
gongyipin => 工艺品
mugongjixieshebei => 木工机械设备
shizheng => 市政
shichangtuiguang => 市场推广
yaodiandianyuan => 药店店员
xidianshi => 西点师
lenggui => 冷柜
xinlizixun => 心理咨询
muqiang => 幕墙
xiaoshou => 销售
fayufanyi => 法语翻译
fanghonggongchengjiyongpin => 防洪工程及用品
jiushengqicai => 救生器材
diandongwanju => 电动玩具
gaoduanshejizhiwei => 高端设计职位
dechanxiangmuzongjian => 地产项目总监
qichedingsunlipei => 汽车定损理赔
gongyilipin => 工艺礼品
hangkong => 航空
tuijiansuanfa => 推荐算法
bangongjiaju => 办公家具
fanqizha => 反欺诈
chayejizhipin => 茶叶及制品
gongchengjianli1 => 工程监理
jinrong => 金融
touyingji => 投影机
qicheshengchan => 汽车生产
huamu => 花木
suliaojiancai => 塑料建材
hangkonggongcheng => 航空工程
yanzhenggongchengshi => IC验证工程师
fuzhubian => 副主编
mianliaofuliaokaifa => 面料辅料开发
lietouguwen => 猎头顾问
jixiejidian => 机械机电
peixun => 培训
shangwuzongjian => 商务总监
jizhe => 记者
zhengquanfenxishi => 证券分析师
qiche => 汽车
tongxindianyuangongchengshi => 通信电源工程师
yuesao => 月嫂
jiulei => 酒类
zhuanghuang => 装潢
xuexiao => 学校
mucaibancai => 木材板材
kefangjingli => 客房经理
baoxian => 保险
jiadian => 家电
haiwaishichang => 海外市场
pibu => 坯布
gongjiao => 公交
houqin => 后勤
zhaoshang => 招商
shucaijizhipin => 蔬菜及制品
danzhipin => 蛋制品
yinhuabu => 印花布
suliao => 塑料
jiaqin => 家禽
weixingkeche => 微型客车
jiankongshebei => 监控设备
chanpin => 产品VP
shengwuzhiyao => 生物制药
xiaofangche => 消防车
jiayongdiannao => 家用电脑
ceshijingli => 测试经理
qilei => 棋类
xiyiji => 洗衣机
jiaju => 家具
tongzhuang => 童装
lengdongshipin => 冷冻食品
xianxiatazhanyunying => 线下拓展运营
ranliao => 染料
jizhuangxiang => 集装箱
touzijingli => 投资经理
shoujiweixiu => 手机维修
meiqikuangyeshebei => 煤气矿业设备
wanju => 玩具
caishuifuwu => 财税服务
fengkongsuanfa => 风控算法
caizhuangguwen => 彩妆顾问
gongre => 供热
wangluotongxinchanpin => 网络通信产品
yunying => 运营
huiji => 会计
kechengbianji => 课程编辑
shengpi => 生皮
xianshusheji => 线束设计
suliaobaozhuangyongpin => 塑料包装用品
shimojitansuchanpin => 石墨及碳素产品
yiyaoxiangmujingli => 医药项目经理
jitajiaoshi => 吉他教师
bisaifuzhuang => 比赛服装
gongyizhichenggongchengshi => 工艺/制程工程师
zhamen => 闸门
bancai => 板材
zhinengjiashixitonggongchengshi => 智能驾驶系统工程师
cangchu1 => 仓储
xiwanji => 洗碗机
kafeishi => 咖啡师
qita => 其它
huanre => 换热
sichou => 丝绸
fuzhuangfangzhisheji => 服装/纺织设计
zhaoshengguwen => 招生顾问
chachegong => 叉车工
shizhenggongyongsheshijianshe => 市政公用设施建设
nisugongyipin => 泥塑工艺品
nvzhuang => 女装
yangmao => 羊毛
cfo => CFO
meirongguwen => 美容顾问
huizhanhuodongxiaoshou => 会展活动销售
yanliao => 颜料
zhuanyongcheliang => 专用车辆
hanjie => 焊接
chuzuche => 出租车
wuyejingli => 物业经理
chongwumeirong => 宠物美容
huagongshebei => 化工设备
xinxijishu => 信息技术
fangshadenggongchenghesheshi => 防沙等工程和设施
yaoye => 药业
chongwuyisheng => 宠物医生
feiliao => 肥料
jixiejigongyezhipin => 机械及工业制品
baoxianjingsuanshi => 保险精算师
jiayongtaoci => 家用陶瓷
pinpaifuzhuang => 品牌服装
shuijinggongyipin => 水晶工艺品
delphi_development => Delphi开发
tongxinshebeigongchengshi => 通信设备工程师
donghuasheji => 动画设计
qiyedangjian => 企业党建
meishuzhidao => 美术指导
jianjishi => 剪辑师
chuguisheji => 橱柜设计
chuanbo => 船舶
zhuanyuan => 专员
caigouzhuanyuan => 采购专员
zhanlvezixun => 战略咨询
wuzi => 物资
chuanganqi => 传感器
yingshi => 影视
chenliesheji => 陈列设计
caiwuguwen => 财务顾问
shengwujiaoshi => 生物教师
wenxiushi => 纹绣师
kafei => 咖啡
dianziwanju => 电子玩具
yangqiji => 氧气机
yinxing => 银行
danbao => 担保
deyufanyi => 德语翻译
jixieweixiubaoyang => 机械维修/保养
diannaoxiangguanyongpin => 电脑相关用品
muye => 木业
zhuli => 助理
jidiangongchengshi => 机电工程师
qinggongshipin => 轻工食品
xifu => 西服
gonggonghuanweijixie => 公共环卫机械
qunuandianqi => 取暖电器
baozhuangsheji => 包装设计
fangdechanxiaoshou => 房地产销售
baozhuangyongzhi => 包装用纸
jinianpin => 纪念品
jiaoxuesheshi => 教学设施
falvfuwu => 法律服务
cangchu => 仓储
tuoguanlaoshi => 托管老师
fuwuyuan => 服务员
shenduxuexi => 深度学习
caigoujingli => 采购经理
fuzhuangfuliao => 服装辅料
gongmeilipinwanjushejijiagong => 工美礼品玩具设计加工
yanju => 烟具
qianduanpeixunjiangshi => Web前端培训讲师
huaxuexianwei => 化学纤维
neiyi => 内衣
dechancehua => 地产策划
shichangguwen => 市场顾问
lvshi => 律师
lvyouchanpinkaifacehua => 旅游产品开发/策划
waimaojingli => 外贸经理
yiyaoyanfa => 医药研发
caigouzhuli => 采购助理
malei => 麻类
suliaowanju => 塑料玩具
baoxianlipei => 保险理赔
qiantingjingli => 前厅经理
zuangong => 钻工
shujukaifa => 数据开发
yingshimeiti => 影视媒体
naihuo => 耐火
kuaidi => 快递
chaoyisheng => B超医生
douzhipin => 豆制品
kuzi => 裤子
lvxingfuwu => 旅行服务
wenju => 文具
hulianwangjinrong1 => 互联网金融
fanggugongyipin => 仿古工艺品
wenhuayongzhi => 文化用纸
zhuguan => 主管
zhengceyanjiu => 政策研究
waimaoyewuyuan => 外贸业务员
xiaoshougongchengshi => 销售工程师
mendiandianzhang => 门店店长
kaoqinji => 考勤机
shiyanshijiaju => 实验室家具
cangkuwenyuan => 仓库文员
jiance => 检测
zhiye => 纸业
gongchengyusuan => 工程预算
xiaofanggongchengshi => 消防工程师
riyonghuaxuepin => 日用化学品
gangkougongcheng => 港口工程
diandongji => 电动机
yuju1 => 渔具
yaodiandianzhang => 药店店长
dianshijiemu => 电视节目
tianrangongyipin => 天然工艺品
motuocheweixiu => 摩托车维修
yakeyisheng => 牙科医生
qichesheji => 汽车设计
reshejigongchengshi => 热设计工程师
chengben => 成本
riliaochushi => 日料厨师
yundonghuju => 运动护具
shejishi => UX设计师
dianzijishibu => 电子记事簿
wangzhancehua => 网站策划
mazhiwu => 麻织物
dianreshebei => 电热设备
zhongbiao => 钟表
gangtiejizhipin => 钢铁及制品
yuanyiyongju => 园艺用具
xiaofang => 消防
tangcizhipin => 搪瓷制品
ceo_zhuli => CEO助理
yueyeqiche => 越野汽车
chuanzhi => 船只
youxizhizuoren => 游戏制作人
lihuoyuan => 理货员
gaozhong => 高中
xiangji => 相机
yurongfuzhuang => 羽绒服装
yinxiang1 => 音响
bianju => 编剧
kechengsheji => 课程设计
lvyouchanpinjingli => 旅游产品经理
hangong => 焊工
canjian => 蚕茧
zhuangshicailiao => 装饰材料
yingshicehua => 影视策划
diangong => 电工
shengchu => 牲畜
shuinijizhipin => 水泥及制品
jiadianweixiu1 => 家电维修
deban => 地板
jiaotonganquansheshi => 交通安全设施
detan => 地毯
feishijuesheji => 非视觉设计
hexiaoyuan => 核销员
jiancai => 建材
huagong => 化工
zhubaosheji => 珠宝设计
tourongzi => 投融资
shuzhi => 树脂
chanpinjingli => 产品经理
daoyi => 导医
shipinyinliaoyuanliao => 食品饮料原料
baoxianguwen => 保险顾问
tuopan => 托盘
gongyingshangzhilianggongchengshi => 供应商质量工程师
huagonggongchengshi => 化工工程师
shujujiagoushi => 数据架构师
zhaomingyudengju => 照明与灯具
bandaoti => 半导体
shengwugongcheng => 生物工程
jishujingli => 技术经理
ruanjiankaifa => 软件开发
tanglei => 糖类
baozhuangxiangguanshebei => 包装相关设备
anfang => 安防
xuqiufenxigongchengshi => 需求分析工程师
huagongxiangmujingli => 化工项目经理
paoguanggong => 抛光工
liangqiliangju => 量器量具
xiangkuang => 相框
xiangbaodaisan => 箱包袋伞
xingzhengzhuguan => 行政主管
huazhuangzaoxingfuzhuang => 化妆/造型/服装
ue4 => UE4
yingshitexiao => 影视特效
menchuang => 门窗
feijinshu => 废金属
jichuang => 机床
yangzhidongwu => 养殖动物
huaxueshiji => 化学试剂
niuzaifuzhuang => 牛仔服装
shuichan => 水产
youxichangjing => 游戏场景
neirongshenhe => 内容审核
wuliuyunying => 物流运营
cjj_peixunjiangshi => C++培训讲师
wangyuechesiji => 网约车司机
liangyoujiagongjixie => 粮油加工机械
dianhuakefu => 电话客服
cheshenzaoxingsheji => 车身/造型设计
tongxunchanpinzhizaoshebei => 通讯产品制造设备
fawuzhuanyuan => 法务专员
fawu => 法务
youyongjiaolian => 游泳教练
qitayishengzhiwei => 其他医生职位
mizhipin => 蜜制品
tongchejipeijian => 童车及配件
doujiangji => 豆浆机
yidongchanpinjingli => 移动产品经理
shineisheji => 室内设计
lvhuagong => 绿化工
fanyi => 翻译
maishou => 买手
dongzhiwuzhongmiao => 动植物种苗
buganjiaozhipin => 不干胶制品
html5_development => HTML5开发
xitongjicheng => 系统集成
toujin => 头巾
wufangbu => 无纺布
zhinengqiche => 智能汽车
mianmo => 面膜
cehuajingli => 策划经理
motuoche => 摩托车
weiyu => 卫浴
youxi => 游戏
chanpinzongjian => 产品总监
yiliaoqixieyanfa => 医疗器械研发
gongyinglianzhuanyuan => 供应链专员
gongkongshebeijipeijianzhuangzhi => 工控设备及配件装置
zaojiazixun => 造价咨询
yinle => 音乐
xitong => GPS系统
baozhuang => 包装
baoguan => 报关
touzihehuoren => 投资合伙人
danzhengyuan => 单证员
tangcishengchanjiagongjixie => 搪瓷生产加工机械
yiyaodaibiao => 医药代表
gaoduangongyinglianzhiwei => 高端供应链职位
shijueshejishi => 视觉设计师
baojiejingli => 保洁经理
zhuanwaqikuai => 砖瓦砌块
ruanjian => 软件
vp => VP
jiaoyuxingzheng => 教育行政
wuyeweixiu => 物业维修
zhongzi => 种子
wangyechanpinjingli => 网页产品经理
seo => SEO
heguijicha => 合规稽查
muqianggongchengshi => 幕墙工程师
zharan => 扎染
dianqi => 电器
perl_development => Perl开发
zhubian => 主编
shangwujingli => 商务经理
dangangui => 档案柜
zhonggong => 重工
jingli => BD经理
jixiegongchengshi => 机械工程师
zixun => 咨询
chengshiguihuasheji => 城市规划设计
shigonganquanyuan => 施工安全员
xiaoshoujishuzhichi => 销售技术支持
bianji => 编辑
chongdianzhuangsheji => 充电桩设计
chakalei => 插卡类
chaye => 茶叶
zhuangaoren => 撰稿人
quanzhangongchengshi => 全栈工程师
manhuashi => 漫画师
canyinxuetu => 餐饮学徒
huayishi => 花艺师
yinshuashebei => 印刷设备
lipin => 礼品
fawuzhuguan => 法务主管
fuwuqi => 服务器
dianzishangwuxiangguan => 电子商务相关
moju => 磨具
dianxinshebei => 电信设备
muzhiwanju => 木制玩具
net_development => .NET开发
dianshangchanpinjingli => 电商产品经理
shouhoukefu => 售后客服
kefuzhuanyuan => 客服专员
jingjiren => 经纪人
huaxuefenxi => 化学分析
jieju => 洁具
shangpinjingli => 商品经理
tongxunchanpinpeijianbujian => 通讯产品配件部件
dezhenshebei => 地震设备
paibansheji => 排版设计
linchuangxiediao => 临床协调
wuliuzhuanyuan => 物流专员
dianyuanyingyeyuan => 店员/营业员
boligongyipin => 玻璃工艺品
qichezhilianggongchengshi => 汽车质量工程师
dianchi => 电池
fangshenyongju => 防身用具
diangongtaocicailiao => 电工陶瓷材料
ruby_development => Ruby开发
shepingongchengshi => 射频工程师
guangtongxingongchengshi => 光通信工程师
wangluoyingxiao => 网络营销
xiaoduiluru => 校对录入
jizhuangxiangguanli => 集装箱管理
cehui => 测绘
pinpaigongguan => 品牌公关
jiake => 夹克
zhazhiji => 榨汁机
fuzhuangjixie => 服装机械
fangdanqicai => 防弹器材
yuanlin => 园林
wuxianshepintongxingongchengshi => 无线/射频通信工程师
kehudaibiao => 客户代表
yaopinzhuce => 药品注册
huangshanlvhua => 荒山绿化
zhengquanjingjiren => 证券经纪人
taiyangneng => 太阳能
ershouqimo => 二手汽摩
boli => 玻璃
yinpinbianji => 音频编辑
fangsunyuan => 防损员
bingxiang => 冰箱
zixunrexian => 咨询热线
yangyigong => 样衣工
bolijizhipin => 玻璃及制品
yasuo => 压缩
sem => SEM
zhishichanquanlvshi => 知识产权律师
duijiangji => 对讲机
yancao => 烟草
fangzhifeiliao => 纺织废料
moju1 => 模具
jijin => 基金
gis_gongchengshi => GIS工程师
rengongzhineng => 人工智能
tezhongjiancai => 特种建材
jinshuzhizao => 金属制造
xiangbao => 箱包
dianqigongchengshi => 电气工程师
suanfayanjiuyuan => 算法研究员
youxishuzhicehua => 游戏数值策划
zongzhanghuiji => 总账会计
zhuangxiuxiangmujingli => 装修项目经理
guangyijipeijian => 光仪及配件
xiaoshouguwen => 销售顾问
yimeizixun => 医美咨询
chumuyangzhiyeshebeijiyongju => 畜牧养殖业设备及用具
gongyezidonghuazhuangzhi => 工业自动化装置
shuinichang => 水泥厂
zhenjiutuina => 针灸推拿
huoyundailizhuanyuan => 货运代理专员
cailiaoyuan => 材料员
canyin => 餐饮
sashuiche => 洒水车
yuanyi => 园艺
daoluqingsaoche => 道路清扫车
gongyegongchengshi => 工业工程师
yousejinshuhejin => 有色金属合金
shujucaiji => 数据采集
dianxiandianlan => 电线电缆
dianzidiangong => 电子电工
zhinengshouji => 智能手机
xitonganquan => 系统安全
jiafang => 家纺
liuxueguwen => 留学顾问
zulin => 租赁
peidianzhuangzhi => 配电装置
zaozhishebei => 造纸设备
huiwuhuizhan => 会务会展
kuaidiyuan => 快递员
shiwusuolvshi => 事务所律师
tiyujiaoshi => 体育教师
renzhenggongchengshi => 认证工程师
zhusugongchengshi => 注塑工程师
xigu => 硒鼓
chuzhong => 初中
shentouceshi => 渗透测试
qitatourongzizhiwei => 其他投融资职位
kekaodugongchengshi => 可靠度工程师
fushi => 服饰
jisuanjifuwu => 计算机服务
arm_kaifa => ARM开发
biaoqian => 标签
jianshenjiaolian => 健身教练
shuxuejiaoshi => 数学教师
daoyou => 导游
shenghuodianqi => 生活电器
jiudian => 酒店
qichelingbujiansheji => 汽车零部件设计
jiayongdianqi => 家用电器
huaxue => 化学
yuye => 渔业
shengchanshebeiguanli => 生产设备管理
jingshuiqi => 净水器
qiegeshebeiyucailiao => 切割设备与材料
wanjupeijian => 玩具配件
bijiben => 笔记本
huizhanhuodongzhixing => 会展活动执行
xiaoshouzhuanyuan => 销售专员
caigou => 采购
yiyao => 医药
huogongchanpin => 火工产品
xunhuji => 寻呼机
pigejirenzaopige => 皮革及人造皮革
menling => 门铃
huodongcehuazhixing => 活动策划执行
zixunguwen => IT咨询顾问
xishengcailiao => 吸声材料
wushujiaolian => 武术教练
chuancaiyuan => 传菜员
wuye => 物业
zhongxue => 中学
huliyongpin => 护理用品
flash_shejishi => Flash设计师
yingyufanyi => 英语翻译
zaguo => 杂果
yongju => 用具
nongyejixie => 农业机械
zhishichanquanzhuanlishangbiaodailiren => 知识产权/专利/商标代理人
caiwuzixunguwen => 财务咨询顾问
gongchengchengbao => 工程承包
guanggao => 广告
yinshuiji => 饮水机
yeyubianji => 业余编辑
gaoduanshichangzhiwei => 高端市场职位
guanjianguancai => 管件管材
jianzhuzhuanghuangsheji => 建筑装潢设计
xiejixiecai => 鞋及鞋材
fangdechankaifa => 房地产开发
linchuangshujufenxi => 临床数据分析
yunshu => 运输
miantiao => 面条
sedai => 色带
jiayongbolizhipin => 家用玻璃制品
muzhibaozhuangyongpin => 木制包装用品
bangongyongpin => 办公用品
zhinengshebei => 智能设备
yingshifaxing => 影视发行
jinrongchanpinjingli => 金融产品经理
shuili => 水利
jiaotonganquan => 交通安全
fadianjizu => 发电机组
daojianshua => 刀剪刷
jixiaokaohe => 绩效考核
taiquandaojiaolian => 跆拳道教练
wujihuagongyuanliao => 无机化工原料
xinxiguanliruanjiankaifasheji => 信息管理软件开发设计
zhinengjiaju => 智能家居
fangchanpinggushi => 房产评估师
kaiguangui => 开关柜
yuyeshebeijiyongju => 渔业设备及用具
wushuichuli => 污水处理
ziranyuyanchuli => 自然语言处理
cangkujingli => 仓库经理
jiaozhanji => 胶粘剂
gonggongqiche => 公共汽车
gudongheshoucangpin => 古董和收藏品
gongreshebei => 供热设备
jianshen => 健身
ruanpan => 软盘
tianchong => 填充
nongyongpin => 农用品
suoju => 锁具
xingnengceshi => 性能测试
ceshikaifa => 测试开发
danpianji => 单片机
qianduankaifa => 前端开发
dechanzhongjie => 地产中介
unity => Unity
wujingongju => 五金工具
diandonggongju => 电动工具
meishujiaoshi => 美术教师
yumao => 羽毛
keche => 客车
jiuyelaoshi => 就业老师
yunweikaifagongchengshi => 运维开发工程师
yixuebianji => 医学编辑
shoushenguwen => 瘦身顾问
tongxinyanfagongchengshi => 通信研发工程师
jiqixuexi => 机器学习
touziguwen => 投资顾问
caigougongchengshi => 采购工程师
python_development => Python开发
shangjiayunying => 商家运营
moxingwanju => 模型玩具
meijiashi => 美甲师
jingyigongchengshi => 精益工程师
weixiu => 维修
coo => COO
yinshuachubanwu => 印刷出版物
zhaomingxiang => 照明箱
gongmeilipin => 工美礼品
nuantonggongchengshi => 暖通工程师
fangxunwuzi => 防汛物资
qichedianzigongchengshi => 汽车电子工程师
jixiugong => 机修工
gongchengqiche => 工程汽车
moliao => 磨料
qichebaoyang => 汽车保养
dianrehu => 电热壶
bangong => 办公
chongwuyongpin => 宠物用品
zongzhuanggongchengshi => 总装工程师
zhujipeijian => 主机配件
tongxinxiangmuzhuanyuan => 通信项目专员
xinmeitiyunying => 新媒体运营
lajichuli => 垃圾处理
youxicehua => 游戏策划
gongguanmeijie => 公关媒介
wuliugendan => 物流跟单
touzi1 => 投资
hunqing => 婚庆
jianzhushigongxianchangguanli => 建筑施工现场管理
dechancehuazongjian => 地产策划总监
bohaoqi => 拨号器
hunfangzhiwu => 混纺织物
yidongkaifa => 移动开发
qichexiaoshou => 汽车销售
zhubo => 主播
lingban => 领班
nongfuchanpinjiagong => 农副产品加工
chuanzhenji => 传真机
huodongcehua => 活动策划
kefangfuwuyuan => 客房服务员
cika => 磁卡
rongmaowanju => 绒毛玩具
jianzhugongchengshi => 建筑工程师
lanchejipeijian => 缆车及配件
shizhengdaolujianshe => 市政道路建设
suliaoshengchanjiagongjixie => 塑料生产加工机械
jidian => 机电
java_development => Java开发
wangzhanjianshe => 网站建设
zhibanshebei => 制版设备
jiayongsuliaozhipin => 家用塑料制品
duomeitishejishi => 多媒体设计师
xiangjiaoshengchanjiagongjixie => 橡胶生产加工机械
ertongfuzhuang => 儿童服装
chongwudian => 宠物店
lunhuajiaolian => 轮滑教练
tazhanpeixun => 拓展培训
hunningtujizhipin => 混凝土及制品
tuliao => 涂料
xiejiagongjixiulishebei => 鞋加工及修理设备
zimeiti => 自媒体
shengchanzuzhanglazhang => 生产组长/拉长
dsp_kaifa => DSP开发
meigong => 美工
qichexiangmuguanli => 汽车项目管理
wutaidengguangyinxiangshebei => 舞台灯光音响设备
chazuo => 插座
shejiyuan => 设计院
shejipeixunjiangshi => UI设计培训讲师
yudingpiaowu => 预定票务
fangchaocailiao => 防潮材料
xinyongkaxiaoshou => 信用卡销售
touzizhuli => 投资助理
neirongyunying => 内容运营
xuanzhikaifa => 选址开发
zhiyeyaoshizhudianyaoshi => 执业药师/驻店药师
chenlieyuan => 陈列员
jixieshejijiagong => 机械设计加工
maojin => 毛巾
yahuhangong => 氩弧焊工
dianti => 电梯
xunxiangjixunxianglu => 熏香及熏香炉
meijieshi => 美睫师
yousejinshuzhipin => 有色金属制品
jisuanqi => 计算器
zhizhigongyipin => 纸制工艺品
zhitu => 制图
xiaoxuejiaoshi => 小学教师
wuyeguanliyuan => 物业管理员
chanhoukangfushi => 产后康复师
zhusugong => 注塑工
zaozhi => 造纸
huiyihuodongxiaoshou => 会议活动销售
shigao => 石膏
diannaoyuruanjian => 电脑与软件
guangdian => 广电
banjia => 搬家
dongman => 动漫
shichangzongjian => 市场总监
shuikongluyuncaozuo => 水/空/陆运操作
xu => T恤
huizhanhuodongcehua => 会展活动策划
neikeyisheng => 内科医生
dianhuaji => 电话机
neiranji => 内燃机
cto => CTO
tuliaoyanfa => 涂料研发
yeyajixiejibujian => 液压机械及部件
minzufuzhuang => 民族服装
jiajuyongpin => 家居用品
vb_development => VB工程师
gangqinjiaoshi => 钢琴教师
dianche => 电车
baijiu => 白酒
shishiguwen => 实施顾问
shipinyinliaojiagongshebei => 食品饮料加工设备
youxianchuanshugongchengshi => 有线传输工程师
zhewangong => 折弯工
linchuangyanjiu => 临床研究
she => 设
cehuiceliang => 测绘/测量
shuiguojizhipin => 水果及制品
nongtianshuiligongcheng => 农田水利工程
zhanlanzhanshisheji => 展览/展示设计
yunshujinglizhuguan => 运输经理/主管
pigefeiliaojichulisheshi => 皮革废料及处理设施
sudongshipin => 速冻食品
weibolu => 微波炉
wuliucangchuxiangmujingli => 物流/仓储项目经理
tongyonglingbujian => 通用零部件
huanbao => 环保
shangwuqudao => 商务渠道
zhumu => 竹木
ruzhipin => 乳制品
fangzhipinshejijiagong => 纺织品设计加工
fangbaoqicai => 防暴器材
yishupeixun => 艺术培训
yinran => 印染
qitawaiyujiaoshi => 其他外语教师
jiajugongchengshi => 夹具工程师
huazhuangpinyanfa => 化妆品研发
zhilengkongdiaoshebei => 制冷空调设备
chuangshangyongpin => 床上用品
renliziyuanjingli => 人力资源经理
xiaozhangfuxiaozhang => 校长/副校长
shouyiyongpin => 兽医用品
keyun => 客运
dianxian => 电线
meifa => 美发
mazhibaozhuangyongpin => 麻制包装用品
yinshuajixie => 印刷机械
weixinyunying => 微信运营
chuijuchuju => 炊具厨具
shicai => 石材
jiajiao => 家教
bizhi => 壁纸
ershoujiaotongchanpinjiyongju => 二手交通产品及用具
dianzishangwu => 电子商务
zhongdiangong => 钟点工
hunningtu => 混凝土
jiagoushi => 架构师
gaoduanyunyingzhiwei => 高端运营职位
meijiecehua => 媒介策划
yisheng => 医生
quankeyisheng => 全科医生
xinlizixunshi => 心理咨询师
houqizhizuo => 后期制作
baoanjingli => 保安经理
changzhang => 厂长
huagongchanpinshejijiagong => 化工产品设计加工
fuzhuangjiagongshebei => 服装加工设备
gongchengjianli => 工程监理
baoan => 保安
shukong1 => 数控
huoyundaili => 货运代理
wangluogongchengshi => 网络工程师
banzhurenfudaoyuan => 班主任/辅导员
songcanyuan => 送餐员
shengchanyingyun => 生产营运
jixieshebeigongchengshi => 机械设备工程师
fanghuocailiao => 防火材料
zhuchiren => 主持人/DJ
xingzhengzongchu => 行政总厨
ruye => 乳业
kaiguan => 开关
guangwangluogongchengshi => 光网络工程师
pingmiansheji => 平面设计
kechengguwen => 课程顾问
gongjuqiche => 工具汽车
yundongfuzhuang => 运动服装
baoanshebei => 保安设备
wangluotuiguang => 网络推广
ios_peixunjiangshi => iOS培训讲师
fuzongcai => 副总裁
dingshiqi => 定时器
tiyusheshi => 体育设施
gongchengjixie => 工程机械
dianxin => 电信
hujiaozhongxinkefu => 呼叫中心客服
nieqingdianchi => 镍氢电池
kuajingdianshangyunying => 跨境电商运营
kehujingli => 客户经理
dianligongcheng => 电力工程
shuma => 数码
youxiceshi => 游戏测试
youxidongzuo => 游戏动作
daijiasiji => 代驾司机
guanggaocailiao => 广告材料
yanjing => 眼镜
nengyuan => 能源
linchuangxiangmujingli => 临床项目经理
motuochejipeijian => 摩托车及配件
lidianchi => 锂电池
bangongwenjiao => 办公文教
shiji => 试剂
ceo => CEO
tiyuchangguanzhuanyongcailiao => 体育场馆专用材料
dongbao => 动保
shouqiankefu => 售前客服
android_development => Android开发
gere => 隔热
yiqi => 仪器
bangongzhizhang => 办公纸张
huijiguwen => 会籍顾问
xindaiguanli => 信贷管理
dechanxiangmuguanli => 地产项目管理
lingdai => 领带
peixunjiangshi => 3D培训讲师
shengchananquanyuan => 生产安全员
yinlegongyisheshijianshe => 音乐公益设施建设
gongguanzongjian => 公关总监
renliziyuanzhuguan => 人力资源主管
meitihechuanbo => 媒体和传播
tushu => 图书
qidonggongju => 气动工具
baojianpin => 保健品
php_peixunjiangshi => PHP培训讲师
youeryuan => 幼儿园
pifashichang => 批发市场
xiangmuzhuli => 项目助理
fae => FAE
guanggaoshenhe => 广告审核
cho => CHO
tianhuaban => 天花板
yinxiangzhipinjidianziduwu => 音像制品及电子读物
wenhuachuanbo => 文化传播
zhiyao => 制药
shengwukeji => 生物科技
kefuzongjian => 客服总监
pika => 皮卡
ka1 => IC卡
bengjizhenkongshebei => 泵及真空设备
yingerfuzhuang => 婴儿服装
anquanfanghu => 安全防护
dayi => 大衣
ceshigongchengshi => 测试工程师
3d_shejishi => 3D设计师
baomu => 保姆
zhijianyuan => 质检员
yudianyuan => UPS与电源
fengrenbianzhi => 缝纫编织
pigezhipin => 皮革制品
haocai => 耗材
cocos2dx => COCOS2DX
shengchangendan => 生产跟单
tezhifuzhuang => 特制服装
dianzidiangongchanpinzhizaoshebei => 电子电工产品制造设备
diangongjixie => 电工机械
fangdechanzhongjie => 房地产中介
yiyuan => 医院
yingxiaozhuguan => 营销主管
jiankangzhengxing => 健康整形
yurong => 羽绒
jituandianhua => 集团电话
fangzhifeiliaochulisheshi => 纺织废料处理设施
sheyingqicai => 摄影器材
jinchukou => 进出口
tiyu => 体育
huodongfang => 活动房
zaishengnengyuan => 再生能源
wanjuche => 玩具车
zhanlan => 展览
youjiao => 幼教
dipangongchengshi => 底盘工程师
yangrong => 羊绒
sanlunchejipeijian => 三轮车及配件
maozhiwu => 毛织物
guangbo => 广播
shishigongchengshi => 实施工程师
kongdiaogong => 空调工
lvyouxiuxianlvyouyongpin => 旅游休闲旅游用品
wenyishebei => 文艺设备
huoyunsiji => 货运司机
kuangyeshebei => 矿业设备
qiyeguanli => 企业管理
mojugong => 模具工
wazi => 袜子
zhuji => 主机
liangcaichushi => 凉菜厨师
jiadianweixiu => 家电维修
gonglu => 公路
fangbianshipin => 方便食品
baoxiangui => 保险柜
binzangyongpin => 殡葬用品
houchu => 后厨
dianyundou => 电熨斗
zhiyaojixie => 制药机械
nodejs_development => Node.js开发
yingyangshi => 营养师
xigong => 铣工
wuyeguanli => 物业管理
dianquchongqi => 电驱虫器
lingshou => 零售
shouhoujishuzhichi => 售后技术支持
zuzhifazhan => 组织发展
gongzuozhan => 工作站
junxuyongpin => 军需用品
wangluoxiaoshou => 网络销售
shujufenxishi => 数据分析师
anmoshi => 按摩师
fangdechan => 房地产
suozhifuzhuang => 梭织服装
diaosu => 雕塑
hadoop_development => Hadoop开发
jianzhuzhuangshiwujin => 建筑装饰五金
peishi => 配饰
qichefuwuguwen => 汽车服务顾问
weiyusheshi => 卫浴设施
zuoyebaohuqicai => 作业保护器材
taiyangsan => 太阳伞
jixiezhizao => 机械制造
hanyouziren => 含油子仁
shukong => CNC/数控
qichepeijian => 汽车配件
shaxian => 纱线
jiayongzhipin => 家用纸品
xiuxianshipin => 休闲食品
renliziyuan => 人力资源VP
shejizhuangxiuyushizhengjianshe => 设计装修与市政建设
dianjigongchengshi => 电机工程师
tiehejinjizhipin => 铁合金及制品
juhewu => 聚合物
tongxindianlanxiangguanchanpin => 通信电缆相关产品
tongxinceshigongchengshi => 通信测试工程师
sousuosuanfa => 搜索算法
shangwuzhuanyuan => 商务专员
leidajiwuxiandaohang => 雷达及无线导航
xiaodugui => 消毒柜
pigejiagongjixie => 皮革加工机械
jiguangyiqi => 激光仪器
zhubaoxiaoshou => 珠宝销售
zhipianren => 制片人
xingyeyanjiu => 行业研究
net_peixunjiangshi => .NET培训讲师
jixieshejishi => 机械设计师
fengji => 风机
zongjiaogongyipin => 宗教工艺品
fenxishi => 分析师
bijibendiannao => 笔记本电脑
sichoufuzhuang => 丝绸服装
huituji => 绘图机
chejianzhuren => 车间主任
fuzhuangfangzhipigegendan => 服装/纺织/皮革跟单
chegong => 车工
siliaojiagongjixie => 饲料加工机械
suliaojizhipin => 塑料及制品
xichenqi => 吸尘器
peixunshi => 培训师
xuetugong => 学徒工
dianlusheji => 电路设计
jiaoxueguanli => 教学管理
chayishi => 茶艺师
wangluogongcheng => 网络工程
jianshen1 => 健身
wudaolaoshi => 舞蹈老师
peijian => 配件
yuju => 雨具
gaoduanchanpinzhiwei => 高端产品职位
chuangyizongjian => 创意总监
diannaochanpinzhizaoshebei => 电脑产品制造设备
caiwujingli => 财务经理
hr_peixunjiangshi => HR培训讲师
shangwusiji => 商务司机
qiyefuwu => 企业服务
zhujiao => 助教
jixiang => 机箱
keshidianhua => 可视电话
xiangmujingli => 项目经理
luyinyinxiao => 录音/音效
zhengoujibianjiegongyipin => 针钩及编结工艺品
kefujingli => 客服经理
xinzifuli => 薪资福利
licaiguwen => 理财顾问
donglixitonggongchengshi => 动力系统工程师
xiecai => 鞋材
dianlan => 电缆
neirongbianji => 内容编辑
laidianxianshiqi => 来电显示器
yingjian => 硬件
dianxinjiaohuangongchengshi => 电信交换工程师
fangzhifuliao => 纺织辅料
jiayongfangzhi => 家用纺织
zidonghuaceshi => 自动化测试
kangfuqixie => 康复器械
qicheweixiu1 => 汽车维修
gongqigongcheng => 供气工程
tongxunheguangboyongche => 通讯和广播用车
guantoushipin => 罐头食品
qingsuan => 清算
yinlejiaoshi => 音乐教师
tixigongchengshi => 体系工程师
jinianjianzhusheshijianshe => 纪念建筑设施建设
fangzhishebeiheqicai => 纺织设备和器材
huaxianzhiwu => 化纤织物
rihua => 日化
jinchukoumaoyi => 进出口贸易
peicaidahe => 配菜打荷
fenmoyejin => 粉末冶金
zhiboyunying => 直播运营
zhipinjiagongjixie => 纸品加工机械
xizhuang => 西装
yunyingzongjian => 运营总监
zuliaoshi => 足疗师
lazhujizhutai => 蜡烛及烛台
lianhechuangshiren => 联合创始人
yishengzhuli => 医生助理
qimofushujixiangguanchanpin => 汽摩附属及相关产品
fenlishebei => 分离设备
luqiao => 路桥
touzizongjian => 投资总监
dianli => 电力
zhenzhifuzhuang => 针织服装
wanjulipin => 玩具礼品
laobaoyongpin => 劳保用品
huoche => 货车
famen => 阀门
gangtie => 钢铁
chahuashi => 插画师
falvguwen => 法律顾问
shaokaoshifu => 烧烤师傅
zilaishuishushuigongcheng => 自来水输水工程
tongxunchanpin => 通讯产品
kanghanwuzi => 抗旱物资
daibiaochufuzeren => 代表处负责人
daba => 大坝
yinxiang => 音箱
yiliaoqixiezhuce => 医疗器械注册
dongwumaozong => 动物毛鬃
jienengzhuangzhi => 节能装置
danganjia => 档案夹
dahuoji => 打火机
zhishichanquan => 知识产权
fengongsi => 分公司
peilijianfahuo => 配/理/拣/发货
gongchengshi => BIM工程师
jiansuji => 减速机
ruanjianceshipeixunjiangshi => 软件测试培训讲师
jinshukuangchan => 金属矿产
fengyi => 风衣
gongchengsheji => 工程设计
huiyi => 会议
shouqianjishuzhichi => 售前技术支持
zhaomingsheji => 照明设计
jiaotongyunshu => 交通/运输
linyeshebeijiyongju => 林业设备及用具
feijinshukuangchan => 非金属矿产
luxiangshebei => 录像设备
chanpinzhuanyuan => 产品专员
canyindianzhang => 餐饮店长
nongyao => 农药
nanzhuang => 男装
zhenzhibu => 针织布
kezhuoyi => 课桌椅
siliaotianjiaji => 饲料添加剂
tongxun => 通讯
shengchanzongjian => 生产总监
zaikeqiche => 载客汽车
canju => 餐具
ui_shejishi => UI设计师
shigongyuan => 施工员
dayangzhiban => 打样/制版
handong => 涵洞
youxiyunying => 游戏运营
meijiejingli => 媒介经理
feijinshukuangwuzhipin => 非金属矿物制品
shaituji => 晒图机
shejizongjian => 设计总监
wangdiandianzhang => 网店店长
pijiu => 啤酒
shihui => 石灰
jijinjifuwu => 及紧急服务
yonghuyunying => 用户运营
yejinshebei => 冶金设备
qinchuroujizhipin => 禽畜肉及制品
chushi => 厨师