anningshi->安宁
anhui->安徽
alaer->阿拉尔
anqing->安庆
alashanmeng->阿拉善盟
ankang->安康
anqiushi->安丘
akesu->阿克苏
andashi->安达
anlushi->安陆
anguoshi->安国
anshan->鞍山
anyang->安阳
aershanshi->阿尔山
aba->阿坝
atushenshi->阿图什
anshun->安顺
aleitaishi->阿勒泰
bayinguoleng->巴音郭楞
bazhoushi->霸州
beianshi->北安
bayannaoermeng->巴彦淖尔
beijing->北京
baisha->白沙
baoting->保亭
baoding->保定
bijie->毕节
baoshan->保山
benxi->本溪
bangbu->蚌埠
beizhenshi->北镇
bozhou->亳州
baiyin->白银
baicheng->白城
binzhou->滨州
bazhong->巴中
boertala->博尔塔拉
boleshi->博乐
beiliushi->北流
potoushi->泊头
beipiaoshi->北票
baotou->包头
baishan->白山
baise->百色
beihai->北海
baoji->宝鸡
changji->昌吉
zhangsha->长沙
chengmaixian->澄迈
changjiang->昌江
cixishi->慈溪
conghuashi->从化
changshushi->常熟
chongzuo->崇左
chuxiong->楚雄
cangzhou->沧州
changyiqu->昌邑
chaoyang->朝阳
chuzhou->滁州
changde->常德
zhangzhi->长治
chifeng->赤峰
zhongqing->重庆
changzhou->常州
changningshi->常宁
chengdou->成都
chenzhou->郴州
zhangleshi->长乐
chibishi->赤壁
chaozhou->潮州
cenxishi->岑溪
chishuishi->赤水
chizhou->池州
zhangchun->长春
zhanggeshi->长葛
chaohu->巢湖
chongzhoushi->崇州
chengde->承德
dongfang->东方
dongchengqu->东城
dehuishi->德惠
dalian->大连
dinganxian->定安
danjiangkoushi->丹江口
dongyangshi->东阳
dongxingshi->东兴
dingxi->定西
dongguan->东莞
dongying->东营
dengfengshi->登封
diaobingshanshi->调兵山
dehong->德宏
danzhou->儋州
dingzhoushi->定州
deyang->德阳
dafengshi->大丰
dengtashi->灯塔
diqing->迪庆
danyangshi->丹阳
dalishi->大理
datong->大同
dandong->丹东
dongningxian->东宁
dunhuangshi->敦煌
dayeshi->大冶
dashiqiaoshi->大石桥
dunhuashi->敦化
daqing->大庆
dezhou->德州
douyunshi->都匀
daanshi->大安
dazhou->达州
dongtaishi->东台
dexingshi->德兴
delinghashi->德令哈
doujiangyanshi->都江堰
dangyangshi->当阳
dengzhoushi->邓州
donggangshi->东港
daxinganling->大兴安岭
eergunashi->额尔古纳
ezhou->鄂州
enshi->恩施
erlianhaoteshi->二连浩特
emeishanshi->峨眉山
enpingshi->恩平
fuanshi->福安
fudingshi->福鼎
fengchengshi->丰城
fushan->佛山
feichengshi->肥城
fuzhou2->抚州
fangchenggang->防城港
fujian->福建
fuyuxian2->扶余
fenyangshi->汾阳
fuyangshi->富阳
fuzhou->福州
fengzhenshi->丰镇
fuquanshi->福泉
fuyang->阜阳
fuxin->阜新
fushun->抚顺
fujinshi->富锦
fuyuanxian->抚远
fenghuashi->奉化
fuqingshi->福清
fengchengshi2->凤城
genheshi->根河
guangshuishi->广水
ganzi->甘孜
gejiushi->个旧
gaoanshi->高安
guoluo->果洛
guangzhou->广州
gaopingshi->高平
gaoyoushi->高邮
gaochengshi->藁城
guizhou->贵州
guipingshi->桂平
gongyishi->巩义
guangyuan->广元
gaomishi->高密
guangan->广安
gaoyaoshi->高要
gaobeidianshi->高碑店
guyuan->固原
gujiaoshi->古交
gaozhoushi->高州
gannan->甘南
guiyang->贵阳
guangdong->广东
gaizhoushi->盖州
guangxi->广西
guanghanshi->广汉
gongzhulingshi->公主岭
gansu->甘肃
geermushi->格尔木
guixishi->贵溪
guigang->贵港
ganzhou->赣州
guilin->桂林
yili->伊犁
neimenggu->内蒙古
jiangsu->江苏
jingjiangshi->靖江
jingdezhen->景德镇
jinzhou->锦州
jinchang->金昌
jieyang->揭阳
jingshanxian->京山
jiangyinshi->江阴
jizhoushi->冀州
jieshoushi->界首
jimoshi->即墨
jilin->吉林
jiangyoushi->江油
jianoushi->建瓯
jiangxi->江西
jinghongshi->景洪
jian->吉安
jiuquan->酒泉
jiaozhoushi->胶州
jining->济宁
jinjiangshi->晋江
jiaoheshi->蛟河
jiangmen->江门
jiangshanshi->江山
jinzhoushi->晋州
jingzhou->荆州
jiamusi->佳木斯
jinzhong->晋中
jixi->鸡西
jintanshi->金坛
jurongshi->句容
jiaxing->嘉兴
jianshi->集安
jiayuguan->嘉峪关
jiaozuo->焦作
jinggangshanshi->井冈山
jinan->济南
jiyuanshi->济源
jinshishi->津市
jingmen->荆门
jiandeshi->建德
jinhua->金华
jishoushi->吉首
jiujiang->九江
jiutaishi->九台
jincheng->晋城
jianyangshi2->简阳
jiexiushi->介休
jianyangshi->建阳
kuerleishi->库尔勒
kangdingxian->康定
kaiyuanshi2->开远
kashen->喀什
kunshan->昆山
kaiyuanshi->开原
kaifeng->开封
kailishi->凯里
kaipingqu->开平
kuitunshi->奎屯
kunming->昆明
kezileisu->克孜勒苏
kelamayi->克拉玛依
liupanshui->六盘水
linjiangshi->临江
lijiang->丽江
lengshuijiangshi->冷水江
lianyuanshi->涟源
lelingshi->乐陵
lianzhoushi->连州
lanxishi->兰溪
lingaoxian->临高
ledong->乐东
lushanqu->庐山
lingshui->陵水
luzhou->泸州
lvliang->吕梁
liaocheng->聊城
lianjiangshi->廉江
leizhoushi->雷州
linxia->临夏
lushuixian->泸水
liaoyang->辽阳
luquanshi->鹿泉
lanzhou->兰州
linhaishi->临海
laohekoushi->老河口
liaoning->辽宁
longyan->龙岩
lepingshi->乐平
linxiangshi->临湘
lishui->丽水
linghaishi->凌海
linyi->临沂
liuyangshi->浏阳
longchangxian->隆昌
laixishi->莱西
luchengshi->潞城
liangshan->凉山
leshan->乐山
laiwu->莱芜
linqingshi->临清
linanshi->临安
longnan->陇南
leiyangshi->耒阳
lingbaoshi->灵宝
langzhongshi->阆中
liuzhou->柳州
longquanshi->龙泉
lingwushi->灵武
lingyuanshi->凌源
langfang->廊坊
luoyang->洛阳
lianyungang->连云港
lasa->拉萨
loudi->娄底
longjingshi->龙井
luodingshi->罗定
linfen->临汾
lilingshi->醴陵
lincang->临沧
linzhoushi->林州
longhaishi->龙海
lechangshi->乐昌
luohe->漯河
liyangshi->溧阳
laibin->来宾
lufengshi->陆丰
liaoyuan->辽源
longkoushi->龙口
laiyangshi->莱阳
laizhoushi->莱州
liuan->六安
mengzhoushi->孟州
maanshan->马鞍山
mengzixian->蒙自
mileixian->弥勒
meizhou->梅州
machengshi->麻城
maoming->茂名
mudanjiang->牡丹江
miluoshi->汨罗
meihekoushi->梅河口
meishan->眉山
mulengshi->穆棱
maerkangxian->马尔康
mingguangshi->明光
mianzhushi->绵竹
mianyang->绵阳
mishanshi->密山
manzhoulishi->满洲里
ningxia->宁夏
nangongshi->南宫
neijiang->内江
ali->阿里
nujiang->怒江
nanning->南宁
nanchong->南充
nantong->南通
nanjing->南京
ningxiangxian->宁乡
nananshi->南安
ningguoshi->宁国
neheshi->讷河
nanyang->南阳
nanchang->南昌
ninganshi->宁安
ningde->宁德
naqu->那曲
ningbo->宁波
nanxiongshi->南雄
nanping->南平
linzhi->林芝
nankangshi->南康
eerduosi->鄂尔多斯
pingliang->平凉
puyang->濮阳
pingdingshan->平顶山
pulandianshi->普兰店
pingquanxian->平泉
putian->莆田
puningshi->普宁
pingdushi->平度
pingxiang->萍乡
puer->普洱
panshishi->磐石
pizhoushi->邳州
pingxiangshi->凭祥
panjin->盘锦
panzhihua->攀枝花
pengzhoushi->彭州
pinghushi->平湖
penglaishi->蓬莱
qinyangshi->沁阳
qionghai->琼海
qingdao->青岛
quanzhou->泉州
qiongzhong->琼中
quzhou->衢州
qiqihaer->齐齐哈尔
qianxinan->黔西南
qingzhoushi->青州
qiandongnan->黔东南
qujing->曲靖
qingtongxiashi->青铜峡
changdou->昌都
qinzhou->钦州
qianshanxian->潜山
qidongshi->启东
qufushi->曲阜
qingyang->庆阳
qingyuan->清远
qiannan->黔南
qianjiang->潜江
qionglaishi->邛崃
qiananshi->迁安
qinghai->青海
qitaihe->七台河
qingzhenshi->清镇
qinhuangdao->秦皇岛
qixiaqu->栖霞
ruichangshi->瑞昌
rikaze->日喀则
ruijinshi->瑞金
ruilishi->瑞丽
ruzhoushi->汝州
rongchengshi->荣成
rushanshi->乳山
ruianshi->瑞安
rizhao->日照
renqiushi->任丘
rugaoshi->如皋
renhuaishi->仁怀
shangqiu->商丘
sanheshi->三河
suqian->宿迁
shaheshi->沙河
shinanqu->市南
shibeiqu->市北
songyuan->松原
suihua->绥化
shangzhishi->尚志
shaoshanshi->韶山
sichuan->四川
suzhou->宿州
shijiazhuang->石家庄
shuozhou->朔州
shihezi->石河子
shaowushi->邵武
sanmenxia->三门峡
shenmuxian->神木
shandong->山东
shannan->山南
shanghai->上海
shouguangshi->寿光
shuangyashan->双鸭山
shaoxing->绍兴
shangyushi->上虞
shenzhoushi->深州
shishishi->石狮
shulanshi->舒兰
shizhongqu->市中
shaoguan->韶关
shashiqu->沙市
siping->四平
shangrao->上饶
shanwei->汕尾
shaoyang->邵阳
sanya->三亚
suifenheshi->绥芬河
shenyang->沈阳
suizhou->随州
shantou->汕头
suining->遂宁
shangluo->商洛
shengzhoushi->嵊州
sanming->三明
sihuishi->四会
shizuishan->石嘴山
shiyan->十堰
shanxi2->陕西
shishoushi->石首
shenfangshi->什邡
shennongjialinqu->神农架
shuangliaoshi->双辽
songzishi->松滋
shanxi->山西
shuangchengshi->双城
shenzhen->深圳
suzhou2->苏州
shuifuxian->水富
tieling->铁岭
taixingshi->泰兴
tunchangxian->屯昌
tianjin2->天津
tengzhoushi->滕州
tumushukeshi->图木舒克
taiyuan->太原
taicangshi->太仓
tonghua->通化
xicang->西藏
tielishi->铁力
tongchengshi->桐城
tengchongxian->腾冲
tongchuan->铜川
tongrenshi->铜仁
tangshan->唐山
tulufan->吐鲁番
taizhou->泰州
tianzhangshi->天长
tumenshi->图们
taishanshi->台山
tianmenshi->天门
taonanshi->洮南
tianshui->天水
taian->泰安
tonglingxian->铜陵
tongjiangshi->同江
tongliao->通辽
tongxiangshi->桐乡
taizhou2->台州
wulanchabushi->乌兰察布
wulumuqi->乌鲁木齐
wuhan->武汉
wuzhishan->五指山
weifang->潍坊
wenchang->文昌
wanning->万宁
wudalianchishi->五大连池
wuhai->乌海
wanyuanshi->万源
wuchangshi->五常
wuzhong->吴忠
wuchuanshi->吴川
wuwei->武威
weihai->威海
wendengshi->文登
wenzhou->温州
wujiaqu->五家渠
wuyishanshi->武夷山
wuxueshi->武穴
wenlingshi->温岭
wuzhou->梧州
wafangdianshi->瓦房店
wugangshi->舞钢
wenshan->文山
wusushi->乌苏
wulanhaoteshi->乌兰浩特
weihuishi->卫辉
wuanshi->武安
weinan->渭南
wuxi->无锡
wuhu->芜湖
wugangshi2->武冈
xinghuashi->兴化
xinminshi->新民
xinjiang->新疆
xinganqu->兴安
xichengqu->西城
xingchengshi->兴城
xiangchengshi->项城
xiaogan->孝感
xintaishi->新泰
xuancheng->宣城
xuzhou->徐州
xiangxiangshi->湘乡
xianqu2->西安
xinyu->新余
xingningshi->兴宁
xingyishi->兴义
xingrenxian->兴仁
xishuangbanna->西双版纳
xingyangshi->荥阳
xinmishi->新密
xinzhengshi->新郑
xinxiang->新乡
xianning->咸宁
xining->西宁
xianyang->咸阳
xinzhou->忻州
xinyang->信阳
xishiqu->西市
xuchang->许昌
xinshiqu->新市
xichangshi->西昌
xiaoyishi->孝义
xinyishi2->新沂
xinjishi->辛集
xinleshi->新乐
xinyishi->信宜
xianggelilaxian->香格里拉
xingpingshi->兴平
xilinguoleimeng->锡林郭勒盟
xilinhaoteshi->锡林浩特
xingtai->邢台
xiantao->仙桃
xiangxi->湘西
xuanweishi->宣威
xiangtan->湘潭
shamen->厦门
xiangyangqu23->襄阳
yuncheng->运城
yueyang->岳阳
yangquan->阳泉
yibin->宜宾
yanshishi->偃师
yonganshi->永安
yangshuoxian->阳朔
yushushi->榆树
yingdeshi->英德
yuchengshi->禹城
yixingshi->宜兴
yiwu->义乌
yongkangshi->永康
yanan->延安
yuyaoshi->余姚
yichun->伊春
yiyang->益阳
yaan->雅安
yizhengshi->仪征
yichengshi->宜城
yunnan->云南
yongjishi->永济
yulin->玉林
yongchengshi->永城
yangjiang->阳江
yinchuan->银川
yingkou->营口
yunfu->云浮
yingchengshi->应城
yushuxian->玉树
yanzhoushi->兖州
yizhoushi->宜州
yancheng->盐城
yuanjiangshi->沅江
leqingshi->乐清
yimashi->义马
yichang->宜昌
yingtan->鹰潭
yangzhongshi->扬中
yantai->烟台
yiningshi->伊宁
yuanpingshi->原平
yumenshi->玉门
yangchunshi->阳春
yanbian->延边
yanjishi->延吉
yichun2->宜春
yuzhoushi->禹州
yuxi->玉溪
yidoushi->宜都
yangzhou->扬州
yulin2->榆林
yongzhou->永州
yakeshishi->牙克石
ziyang->资阳
zhejiang->浙江
zhongxiangshi->钟祥
zhangshushi->樟树
zhumadian->驻马店
zengchengqu->增城
zhangjiagangshi->张家港
zaoyangshi->枣阳
zhenjiang->镇江
zhuhai->珠海
zigong->自贡
zhuchengshi->诸城
zhuangheshi->庄河
zunyi->遵义
zhaoqing->肇庆
zhaodongshi->肇东
zhuzhou->株洲
zhuozhoushi->涿州
zibo->淄博
zhangzhou->漳州
zhangjiakou->张家口
zhongshan->中山
zhoushan->舟山
zhangye->张掖
zhangpingshi->漳平
zhaotong->昭通
zhujishi->诸暨
zhangqiushi->章丘
zouchengshi->邹城
zhoukou->周口
zhangjiajie->张家界
zaozhuang->枣庄
zhanjiang->湛江
zoupingxian->邹平
zhijiangshi->枝江
zixingshi->资兴
zunhuashi->遵化
zhengzhou->郑州
zhongwei->中卫
zhaoyuanshi->招远
zhalantunshi->扎兰屯